01000100000000000001
01010101111101011111
01010100010101010001
01011111010101110101
01000001010100010101
01110101010111010101
00010101000001000101
11010101011111011101
0101010001X001010001
01011101110101110101
01000101000100000101
01110111011111111101
00010000010000000101
11011111110111111101
00010000010000000001
01110101110111111111
00000100010001000101
01111111011101010101
00000001000000010001
11111111111111111111